---
repo: vinta/awesome-python
readme_filename: vinta_awesome-python_README.md
stars: 248077
forks: 25866
watchers: 248077
contributors_count: 368
license: NOASSERTION
Header 1: Awesome Python [![Awesome](https://cdn.rawgit.com/sindresorhus/awesome/d7305f38d29fed78fa85652e3a63e154dd8e8829/media/badge.svg)](https://github.com/sindresorhus/awesome)
Header 2: Text Processing
---
*Libraries for parsing and manipulating plain texts.*  
* General
* chardet - Python 2/3 compatible character encoding detector.
* difflib - (Python standard library) Helpers for computing deltas.
* ftfy - Makes Unicode text less broken and more consistent automagically.
* fuzzywuzzy - Fuzzy String Matching.
* Levenshtein - Fast computation of Levenshtein distance and string similarity.
* pangu.py - Paranoid text spacing.
* pyfiglet - An implementation of figlet written in Python.
* pypinyin - Convert Chinese hanzi (漢字) to pinyin (拼音).
* textdistance - Compute distance between sequences with 30+ algorithms.
* unidecode - ASCII transliterations of Unicode text.
* Slugify
* awesome-slugify - A Python slugify library that can preserve unicode.
* python-slugify - A Python slugify library that translates unicode to ASCII.
* unicode-slugify - A slugifier that generates unicode slugs with Django as a dependency.
* Unique identifiers
* hashids - Implementation of hashids in Python.
* shortuuid - A generator library for concise, unambiguous and URL-safe UUIDs.
* Parser
* ply - Implementation of lex and yacc parsing tools for Python.
* pygments - A generic syntax highlighter.
* pyparsing - A general purpose framework for generating parsers.
* python-nameparser - Parsing human names into their individual components.
* python-phonenumbers - Parsing, formatting, storing and validating international phone numbers.
* python-user-agents - Browser user agent parser.
* sqlparse - A non-validating SQL parser.