---
repo: vinta/awesome-python
readme_filename: vinta_awesome-python_README.md
stars: 248053
forks: 25865
watchers: 248053
contributors_count: 368
license: NOASSERTION
Header 1: Awesome Python [![Awesome](https://cdn.rawgit.com/sindresorhus/awesome/d7305f38d29fed78fa85652e3a63e154dd8e8829/media/badge.svg)](https://github.com/sindresorhus/awesome)
Header 2: Science
---
*Libraries for scientific computing. Also see Python-for-Scientists.*  
* astropy - A community Python library for Astronomy.
* bcbio-nextgen - Providing best-practice pipelines for fully automated high throughput sequencing analysis.
* bccb - Collection of useful code related to biological analysis.
* Biopython - Biopython is a set of freely available tools for biological computation.
* cclib - A library for parsing and interpreting the results of computational chemistry packages.
* Colour - Implementing a comprehensive number of colour theory transformations and algorithms.
* Karate Club - Unsupervised machine learning toolbox for graph structured data.
* NetworkX - A high-productivity software for complex networks.
* NIPY - A collection of neuroimaging toolkits.
* NumPy - A fundamental package for scientific computing with Python.
* ObsPy - A Python toolbox for seismology.
* Open Babel - A chemical toolbox designed to speak the many languages of chemical data.
* PyDy - Short for Python Dynamics, used to assist with workflow in the modeling of dynamic motion.
* PyMC - Markov Chain Monte Carlo sampling toolkit.
* QuTiP - Quantum Toolbox in Python.
* RDKit - Cheminformatics and Machine Learning Software.
* SciPy - A Python-based ecosystem of open-source software for mathematics, science, and engineering.
* SimPy -  A process-based discrete-event simulation framework.
* statsmodels - Statistical modeling and econometrics in Python.
* SymPy - A Python library for symbolic mathematics.
* Zipline - A Pythonic algorithmic trading library.